//MAP CONVERTED BY dmm2tgm.py THIS HEADER COMMENT PREVENTS RECONVERSION, DO NOT REMOVE
"al" = (
/obj/item/storage/backpack/duffelbag/med/surgery,
/obj/structure/table/glass,
/obj/item/reagent_containers/medigel/sterilizine,
/turf/open/floor/plasteel/white,
/area/space)
"aO" = (
/obj/structure/chair/office{
	dir = 1
	},
/turf/open/floor/plasteel/mono,
/area/space)
"aY" = (
/obj/structure/railing{
	dir = 8;
	layer = 4.1
	},
/turf/open/floor/plasteel/stairs{
	icon = 'icons/obj/stairs.dmi';
	dir = 2
	},
/area/space)
"be" = (
/obj/effect/turf_decal/techfloor,
/obj/structure/railing{
	dir = 8
	},
/turf/open/floor/vault,
/area/space)
"br" = (
/obj/structure/railing{
	dir = 10
	},
/obj/structure/closet/secure_closet/engineering_personal,
/turf/open/floor/plasteel/tech,
/area/space)
"cb" = (
/turf/open/floor/plasteel/mono/dark,
/area/space)
"de" = (
/turf/open/floor/plasteel/stairs{
	dir = 8
	},
/area/space)
"dn" = (
/obj/structure/window/plasma/reinforced/plastitanium,
/turf/open/floor/plating/airless,
/area/space)
"dr" = (
/obj/effect/turf_decal/trimline/opaque/bar/line{
	dir = 1
	},
/obj/structure/curtain,
/turf/open/floor/plasteel/white,
/area/space)
"dJ" = (
/obj/structure/curtain/cloth,
/turf/open/floor/plasteel/patterned/brushed,
/area/space)
"dL" = (
/obj/effect/turf_decal/trimline/opaque/lightgrey/filled/line{
	dir = 1
	},
/turf/open/floor/plasteel/patterned/brushed,
/area/space)
"eF" = (
/obj/effect/turf_decal/industrial/warning{
	dir = 10
	},
/turf/open/floor/plasteel/mono/dark,
/area/space)
"fb" = (
/obj/effect/turf_decal/trimline/opaque/bar/filled/line{
	dir = 4
	},
/turf/open/floor/plasteel/white,
/area/space)
"fN" = (
/obj/effect/turf_decal/corner_steel_grid/full{
	dir = 1
	},
/obj/effect/turf_decal/trimline/opaque/lightgrey/filled/corner{
	dir = 8
	},
/obj/machinery/autolathe,
/turf/open/floor/plasteel/patterned/brushed,
/area/space)
"fT" = (
/turf/closed/wall/mineral/plastitanium,
/area/space)
"hJ" = (
/obj/effect/turf_decal/corner_steel_grid{
	dir = 5
	},
/obj/effect/turf_decal/trimline/opaque/lightgrey/filled/line,
/obj/structure/sink{
	pixel_y = 25
	},
/turf/open/floor/plasteel/patterned/brushed,
/area/space)
"hQ" = (
/obj/structure/closet/crate/chem,
/obj/item/reagent_containers/glass/chem_jug/copper,
/obj/item/reagent_containers/glass/chem_jug/hydrogen,
/obj/item/reagent_containers/glass/chem_jug/iodine,
/obj/item/reagent_containers/glass/chem_jug/nitrogen,
/obj/item/reagent_containers/glass/chem_jug/potassium,
/turf/open/floor/plasteel/white,
/area/space)
"iu" = (
/obj/effect/turf_decal/corner/opaque/lightgrey/diagonal,
/obj/structure/chair/office/dark,
/turf/open/floor/plasteel/patterned/brushed,
/area/space)
"jh" = (
/obj/structure/closet/crate/chem,
/obj/item/reagent_containers/glass/chem_jug/aluminium,
/obj/item/reagent_containers/glass/chem_jug/bromine,
/obj/item/reagent_containers/glass/chem_jug/carbon,
/obj/item/reagent_containers/glass/chem_jug/chlorine,
/obj/item/reagent_containers/glass/chem_jug/oxygen,
/turf/open/floor/plasteel/white,
/area/space)
"jr" = (
/obj/effect/turf_decal/corner_steel_grid/full{
	dir = 1
	},
/obj/effect/turf_decal/trimline/opaque/lightgrey/filled/corner{
	dir = 8
	},
/turf/open/floor/plasteel/patterned/brushed,
/area/space)
"jJ" = (
/obj/machinery/door/airlock/medical{
	dir = 4
	},
/turf/open/floor/plasteel/dark,
/area/space)
"jP" = (
/obj/structure/railing,
/obj/effect/turf_decal/industrial/warning/cee{
	dir = 4
	},
/turf/open/floor/plasteel/mono/dark,
/area/space)
"kj" = (
/obj/effect/turf_decal/industrial/warning{
	dir = 1
	},
/obj/effect/turf_decal/industrial/warning/corner,
/turf/open/floor/plasteel/mono/dark,
/area/space)
"kl" = (
/turf/open/floor/plasteel/stairs{
	icon = 'icons/obj/stairs.dmi';
	dir = 8
	},
/area/space)
"kx" = (
/obj/machinery/computer/station_alert/retro{
	dir = 1
	},
/turf/open/floor/plasteel/mono,
/area/space)
"ld" = (
/obj/effect/turf_decal/trimline/opaque/lightgrey/filled/line,
/turf/open/floor/plasteel/patterned/brushed,
/area/space)
"lM" = (
/turf/open/floor/plating/airless,
/area/space)
"ms" = (
/turf/open/floor/plasteel/stairs{
	icon = 'icons/obj/stairs.dmi';
	dir = 2
	},
/area/space)
"mS" = (
/obj/effect/turf_decal/corner_steel_grid{
	dir = 9
	},
/obj/effect/turf_decal/trimline/opaque/lightgrey/filled/line{
	dir = 4
	},
/obj/machinery/chem_heater,
/turf/open/floor/plasteel/patterned/brushed,
/area/space)
"nP" = (
/obj/effect/turf_decal/corner_steel_grid/full,
/obj/effect/turf_decal/trimline/opaque/lightgrey/filled/corner{
	dir = 4
	},
/obj/structure/table/chem,
/obj/item/reagent_containers/glass/filter{
	pixel_x = -5;
	pixel_y = 3
	},
/obj/item/reagent_containers/glass/filter{
	pixel_y = -5;
	pixel_x = -5
	},
/obj/item/reagent_containers/glass/filter{
	pixel_x = -3;
	pixel_y = -3
	},
/obj/item/reagent_containers/glass/filter,
/turf/open/floor/plasteel/patterned/brushed,
/area/space)
"nY" = (
/obj/effect/turf_decal/corner/opaque/lightgrey/diagonal,
/obj/structure/table/chem,
/turf/open/floor/plasteel/patterned/brushed,
/area/space)
"ol" = (
/obj/structure/closet/secure_closet/medical3,
/turf/open/floor/plasteel/white,
/area/space)
"pP" = (
/obj/effect/turf_decal/corner/opaque/lightgrey/diagonal,
/obj/effect/turf_decal/corner/opaque/lightgrey/diagonal,
/turf/open/floor/plasteel/patterned/brushed,
/area/space)
"pV" = (
/obj/effect/turf_decal/corner/opaque/neutral/half{
	dir = 1
	},
/turf/open/floor/vault,
/area/space)
"qk" = (
/obj/effect/turf_decal/industrial/warning{
	dir = 9
	},
/turf/open/floor/plasteel/mono/dark,
/area/space)
"rb" = (
/obj/structure/window/spawner/east,
/obj/structure/table,
/turf/open/floor/plasteel/mono,
/area/space)
"rJ" = (
/obj/effect/turf_decal/corner_steel_grid{
	dir = 10
	},
/obj/effect/turf_decal/trimline/opaque/lightgrey/filled/line{
	dir = 1
	},
/turf/open/floor/plasteel/patterned/brushed,
/area/space)
"rL" = (
/obj/structure/closet/toolcloset,
/turf/open/floor/plasteel/tech,
/area/space)
"sc" = (
/obj/effect/turf_decal/corner_steel_grid{
	dir = 9
	},
/obj/effect/turf_decal/trimline/opaque/lightgrey/filled/line{
	dir = 4
	},
/obj/structure/table/chem,
/obj/item/reagent_containers/glass/chem_jug/carbon{
	pixel_y = 3;
	pixel_x = 4
	},
/obj/item/reagent_containers/glass/chem_jug/hydrogen{
	pixel_x = -6;
	pixel_y = 6
	},
/obj/item/reagent_containers/glass/chem_jug/nitrogen{
	pixel_x = -6
	},
/obj/item/clothing/glasses/science,
/turf/open/floor/plasteel/patterned/brushed,
/area/space)
"sr" = (
/obj/structure/window/spawner/north,
/obj/structure/table,
/obj/structure/window/spawner/east,
/turf/open/floor/plasteel/mono,
/area/space)
"sE" = (
/obj/machinery/computer/helm{
	dir = 8
	},
/turf/open/floor/plasteel/dark,
/area/space)
"sQ" = (
/obj/structure/table/glass,
/obj/item/storage/backpack/duffelbag/med/surgery,
/obj/item/reagent_containers/medigel/sterilizine,
/turf/open/floor/plasteel/white,
/area/space)
"ts" = (
/obj/structure/rack,
/turf/open/floor/plasteel/tech/techmaint,
/area/space)
"tG" = (
/obj/structure/chair/office/light{
	dir = 4
	},
/turf/open/floor/plasteel/white,
/area/space)
"tK" = (
/obj/machinery/defibrillator_mount/loaded{
	pixel_y = 25
	},
/turf/open/floor/plasteel/white,
/area/space)
"tQ" = (
/obj/effect/turf_decal/corner_steel_grid{
	dir = 6
	},
/obj/effect/turf_decal/trimline/opaque/lightgrey/filled/line{
	dir = 8
	},
/turf/open/floor/plasteel/patterned/brushed,
/area/space)
"tT" = (
/obj/effect/turf_decal/corner/opaque/neutral/three_quarters,
/obj/effect/turf_decal/trimline/opaque/bar/filled/line{
	dir = 4
	},
/turf/open/floor/vault,
/area/space)
"uc" = (
/obj/effect/turf_decal/corner_steel_grid/full{
	dir = 8
	},
/obj/effect/turf_decal/trimline/opaque/lightgrey/filled/corner,
/turf/open/floor/plasteel/patterned/brushed,
/area/space)
"uz" = (
/obj/effect/turf_decal/corner/opaque/neutral/half{
	dir = 8
	},
/obj/effect/turf_decal/trimline/opaque/bar/filled/line{
	dir = 8
	},
/turf/open/floor/vault,
/area/space)
"uP" = (
/obj/structure/railing{
	dir = 4
	},
/turf/open/floor/plasteel/stairs{
	icon = 'icons/obj/stairs.dmi';
	dir = 2
	},
/area/space)
"va" = (
/obj/effect/turf_decal/corner/opaque/neutral/three_quarters{
	dir = 1
	},
/obj/effect/turf_decal/trimline/opaque/bar/filled/line{
	dir = 8
	},
/turf/open/floor/vault,
/area/space)
"wb" = (
/obj/structure/table/reinforced,
/obj/item/paper_bin,
/obj/item/folder/blue,
/obj/item/pen/fountain/captain,
/turf/open/floor/plasteel/dark,
/area/space)
"wl" = (
/turf/open/floor/plasteel/tech/techmaint,
/area/space)
"wq" = (
/turf/open/floor/plasteel/stairs{
	icon = 'icons/obj/stairs.dmi';
	dir = 1
	},
/area/space)
"ws" = (
/obj/machinery/power/port_gen/pacman,
/turf/open/floor/plating/airless,
/area/space)
"xh" = (
/obj/effect/turf_decal/industrial/warning{
	dir = 4
	},
/turf/open/floor/plasteel/mono/dark,
/area/space)
"xN" = (
/turf/open/floor/plasteel/dark,
/area/space)
"yO" = (
/obj/effect/turf_decal/corner_steel_grid{
	dir = 5
	},
/obj/effect/turf_decal/trimline/opaque/lightgrey/filled/line,
/obj/structure/closet/secure_closet/medical3,
/turf/open/floor/plasteel/patterned/brushed,
/area/space)
"zu" = (
/obj/effect/turf_decal/corner/opaque/lightgrey/diagonal,
/obj/structure/table/reinforced,
/obj/item/stack/sheet/metal/fifty,
/turf/open/floor/plasteel/patterned/brushed,
/area/space)
"zv" = (
/obj/structure/chair,
/turf/open/floor/plasteel/dark,
/area/space)
"zK" = (
/obj/effect/turf_decal/techfloor,
/obj/structure/railing{
	dir = 4
	},
/turf/open/floor/vault,
/area/space)
"zT" = (
/obj/structure/window/plasma/reinforced/plastitanium,
/turf/open/floor/plating,
/area/space)
"AN" = (
/obj/machinery/door/window/eastleft,
/turf/open/floor/plasteel/mono,
/area/space)
"AV" = (
/obj/structure/closet/secure_closet/engineering_electrical,
/turf/open/floor/plasteel/tech,
/area/space)
"AZ" = (
/obj/machinery/power/smes/shuttle/precharged{
	dir = 4
	},
/turf/open/floor/plating/airless,
/area/space)
"Bx" = (
/obj/machinery/smartfridge/chemistry,
/turf/open/floor/plasteel/white,
/area/space)
"Ck" = (
/obj/machinery/atmospherics/components/unary/shuttle/heater{
	dir = 4
	},
/turf/open/floor/plating,
/area/space)
"Cn" = (
/obj/machinery/door/airlock/medical{
	dir = 4
	},
/turf/open/floor/plasteel/white,
/area/space)
"Cq" = (
/obj/effect/turf_decal/industrial/warning,
/turf/open/floor/plasteel/mono/dark,
/area/space)
"CR" = (
/obj/structure/tank_dispenser,
/turf/open/floor/plasteel/tech/techmaint,
/area/space)
"CX" = (
/obj/machinery/power/shuttle/engine/electric{
	dir = 4
	},
/turf/open/floor/plating/airless,
/area/space)
"Dh" = (
/obj/effect/turf_decal/industrial/warning{
	dir = 8
	},
/turf/open/floor/plasteel/mono/dark,
/area/space)
"Dv" = (
/turf/open/floor/engine/hull/reinforced,
/area/space)
"Dx" = (
/obj/structure/railing{
	dir = 1
	},
/turf/open/floor/plasteel/tech,
/area/space)
"DS" = (
/obj/structure/railing,
/turf/open/floor/plasteel/tech,
/area/space)
"DW" = (
/turf/open/floor/plating,
/area/space)
"DX" = (
/obj/structure/table/reinforced,
/obj/machinery/fax/indie,
/turf/open/floor/plasteel/dark,
/area/space)
"Es" = (
/turf/closed/wall/mineral/plastitanium/nodiagonal,
/area/space)
"Et" = (
/obj/effect/turf_decal/corner/opaque/neutral/half{
	dir = 4
	},
/obj/effect/turf_decal/trimline/opaque/bar/filled/line{
	dir = 4
	},
/turf/open/floor/vault,
/area/space)
"EJ" = (
/obj/effect/turf_decal/corner_steel_grid/full,
/obj/effect/turf_decal/trimline/opaque/lightgrey/filled/corner{
	dir = 4
	},
/turf/open/floor/plasteel/patterned/brushed,
/area/space)
"EL" = (
/obj/machinery/power/ship_gravity,
/turf/open/floor/plating/airless,
/area/space)
"Fc" = (
/obj/effect/turf_decal/corner_steel_grid{
	dir = 10
	},
/obj/effect/turf_decal/trimline/opaque/lightgrey/filled/line{
	dir = 1
	},
/obj/structure/table/chem,
/turf/open/floor/plasteel/patterned/brushed,
/area/space)
"Fv" = (
/obj/effect/turf_decal/trimline/opaque/bar/line,
/obj/structure/curtain,
/turf/open/floor/plasteel/white,
/area/space)
"FD" = (
/obj/effect/turf_decal/corner/opaque/neutral/three_quarters{
	dir = 8
	},
/obj/effect/turf_decal/trimline/opaque/bar/filled/line{
	dir = 4
	},
/turf/open/floor/vault,
/area/space)
"FH" = (
/obj/machinery/door/poddoor,
/obj/machinery/power/shieldwallgen/atmos{
	anchored = 1;
	dir = 4;
	id = "premier_cargo_holo";
	locked = 1
	},
/turf/open/floor/plasteel/tech/techmaint,
/area/space)
"FP" = (
/obj/effect/turf_decal/corner_steel_grid/full{
	dir = 8
	},
/obj/effect/turf_decal/trimline/opaque/lightgrey/filled/corner,
/obj/structure/closet/secure_closet/medical3,
/turf/open/floor/plasteel/patterned/brushed,
/area/space)
"Gh" = (
/obj/effect/turf_decal/corner/opaque/lightgrey/diagonal,
/obj/structure/table/reinforced,
/turf/open/floor/plasteel/patterned/brushed,
/area/space)
"Gi" = (
/obj/structure/closet/radiation,
/turf/open/floor/plasteel/tech,
/area/space)
"Gs" = (
/obj/effect/turf_decal/corner/opaque/lightgrey/diagonal,
/turf/open/floor/plasteel/patterned/brushed,
/area/space)
"GD" = (
/obj/machinery/door/poddoor,
/turf/open/floor/plasteel/tech/techmaint,
/area/space)
"Hg" = (
/obj/structure/chair{
	dir = 1
	},
/turf/open/floor/plasteel/dark,
/area/space)
"HJ" = (
/obj/effect/turf_decal/corner/opaque/neutral/three_quarters{
	dir = 4
	},
/obj/effect/turf_decal/trimline/opaque/bar/filled/line{
	dir = 8
	},
/turf/open/floor/vault,
/area/space)
"JR" = (
/turf/open/space/basic,
/area/space)
"JY" = (
/obj/machinery/computer/crew{
	dir = 8
	},
/turf/open/floor/plasteel/dark,
/area/space)
"Kn" = (
/obj/structure/table/glass,
/turf/open/floor/plasteel/white,
/area/space)
"KC" = (
/obj/structure/table/reinforced,
/turf/open/floor/plasteel/mono/dark,
/area/space)
"Lb" = (
/obj/effect/turf_decal/corner_steel_grid{
	dir = 10
	},
/obj/effect/turf_decal/trimline/opaque/lightgrey/filled/line{
	dir = 1
	},
/obj/structure/table/chem,
/obj/machinery/reagentgrinder/constructed,
/turf/open/floor/plasteel/patterned/brushed,
/area/space)
"LH" = (
/obj/structure/railing{
	dir = 9;
	layer = 2.9
	},
/obj/structure/closet/secure_closet/engineering_personal,
/turf/open/floor/plasteel/tech,
/area/space)
"LK" = (
/obj/effect/turf_decal/industrial/warning/cee{
	dir = 4
	},
/turf/open/floor/plasteel/mono/dark,
/area/space)
"Mf" = (
/obj/machinery/computer/operating{
	dir = 1
	},
/turf/open/floor/plasteel/white,
/area/space)
"Mw" = (
/obj/effect/turf_decal/corner_steel_grid{
	dir = 9
	},
/obj/effect/turf_decal/trimline/opaque/lightgrey/filled/line{
	dir = 4
	},
/turf/open/floor/plasteel/patterned/brushed,
/area/space)
"Om" = (
/obj/structure/table/optable{
	dir = null
	},
/turf/open/floor/plasteel/white,
/area/space)
"PE" = (
/obj/effect/turf_decal/corner/opaque/neutral/half,
/turf/open/floor/vault,
/area/space)
"PF" = (
/obj/structure/railing{
	dir = 2;
	layer = 4.1
	},
/turf/open/floor/plasteel/stairs{
	icon = 'icons/obj/stairs.dmi';
	dir = 4
	},
/area/space)
"PH" = (
/obj/structure/railing{
	dir = 8;
	layer = 4.1
	},
/turf/open/floor/plasteel/tech,
/area/space)
"Qe" = (
/turf/open/floor/vault,
/area/space)
"Qx" = (
/obj/structure/chair/comfy/shuttle{
	dir = 4;
	name = "Helm"
	},
/turf/open/floor/plasteel/dark,
/area/space)
"Re" = (
/obj/machinery/door/airlock/maintenance,
/turf/open/floor/plating,
/area/space)
"Ro" = (
/obj/machinery/power/shuttle/engine/fueled/plasma{
	dir = 4
	},
/turf/open/floor/plating,
/area/space)
"RR" = (
/obj/effect/turf_decal/corner_steel_grid{
	dir = 5
	},
/obj/effect/turf_decal/trimline/opaque/lightgrey/filled/line,
/obj/structure/table/reinforced,
/turf/open/floor/plasteel/patterned/brushed,
/area/space)
"RY" = (
/obj/machinery/computer/operating,
/turf/open/floor/plasteel/white,
/area/space)
"Sq" = (
/turf/open/floor/plasteel/mono,
/area/space)
"SC" = (
/obj/effect/turf_decal/techfloor{
	dir = 1
	},
/obj/structure/railing{
	dir = 4
	},
/turf/open/floor/vault,
/area/space)
"SH" = (
/obj/effect/turf_decal/corner_steel_grid/full{
	dir = 4
	},
/obj/effect/turf_decal/trimline/opaque/lightgrey/filled/corner{
	dir = 1
	},
/turf/open/floor/plasteel/patterned/brushed,
/area/space)
"SI" = (
/obj/effect/turf_decal/corner_steel_grid{
	dir = 10
	},
/obj/effect/turf_decal/trimline/opaque/lightgrey/filled/line{
	dir = 1
	},
/obj/structure/table/chem,
/obj/item/reagent_containers/glass/beaker/large,
/obj/item/reagent_containers/glass/beaker/large,
/obj/item/reagent_containers/glass/beaker/large,
/obj/item/reagent_containers/glass/beaker/large,
/obj/item/reagent_containers/glass/beaker/large,
/obj/item/reagent_containers/glass/beaker/large,
/obj/item/storage/belt/medical,
/turf/open/floor/plasteel/patterned/brushed,
/area/space)
"Ti" = (
/obj/effect/turf_decal/industrial/warning{
	dir = 1
	},
/turf/open/floor/plasteel/mono/dark,
/area/space)
"Uv" = (
/obj/effect/turf_decal/techfloor{
	dir = 1
	},
/obj/structure/railing{
	dir = 8
	},
/turf/open/floor/vault,
/area/space)
"UL" = (
/obj/machinery/power/smes/engineering,
/turf/open/floor/plating/airless,
/area/space)
"Vx" = (
/obj/effect/turf_decal/corner_steel_grid{
	dir = 5
	},
/obj/effect/turf_decal/trimline/opaque/lightgrey/filled/line,
/turf/open/floor/plasteel/patterned/brushed,
/area/space)
"VI" = (
/obj/structure/railing,
/turf/open/floor/plasteel/stairs{
	icon = 'icons/obj/stairs.dmi';
	dir = 4
	},
/area/space)
"WO" = (
/obj/machinery/defibrillator_mount/loaded{
	pixel_y = -25
	},
/turf/open/floor/plasteel/white,
/area/space)
"XA" = (
/obj/machinery/computer/cargo/express/retro{
	dir = 1
	},
/turf/open/floor/plasteel/mono,
/area/space)
"XF" = (
/obj/machinery/photocopier,
/turf/open/floor/plasteel/dark,
/area/space)
"XO" = (
/obj/machinery/door/airlock/glass{
	dir = 4
	},
/turf/open/floor/plasteel/dark,
/area/space)
"XX" = (
/obj/effect/turf_decal/industrial/warning,
/obj/effect/turf_decal/industrial/warning/corner{
	dir = 4
	},
/turf/open/floor/plasteel/mono/dark,
/area/space)
"Yg" = (
/turf/open/floor/plasteel/tech,
/area/space)
"Yk" = (
/obj/structure/closet/secure_closet/engineering_welding,
/turf/open/floor/plasteel/tech,
/area/space)
"Yn" = (
/obj/structure/table/reinforced,
/turf/open/floor/plasteel/dark,
/area/space)
"YL" = (
/obj/structure/railing,
/turf/closed/wall/mineral/plastitanium/nodiagonal,
/area/space)
"YX" = (
/turf/open/floor/plasteel/white,
/area/space)
"Zm" = (
/obj/machinery/door/poddoor,
/obj/machinery/power/shieldwallgen/atmos{
	anchored = 1;
	dir = 8;
	id = "premier_cargo_holo";
	locked = 1
	},
/turf/open/floor/plasteel/tech/techmaint,
/area/space)
"ZA" = (
/obj/structure/window/spawner/north,
/obj/structure/table,
/turf/open/floor/plasteel/mono,
/area/space)
"ZD" = (
/obj/structure/table/glass,
/obj/item/reagent_containers/spray/cleaner,
/obj/item/defibrillator/loaded,
/turf/open/floor/plasteel/white,
/area/space)

(1,1,1) = {"
JR
JR
JR
JR
JR
JR
JR
JR
JR
JR
JR
JR
JR
fT
CX
CX
CX
fT
JR
JR
JR
JR
JR
JR
JR
JR
JR
JR
JR
JR
"}
(2,1,1) = {"
JR
JR
JR
JR
JR
JR
JR
JR
JR
JR
JR
JR
fT
Es
AZ
AZ
AZ
Es
fT
JR
JR
JR
JR
JR
JR
JR
JR
JR
JR
JR
"}
(3,1,1) = {"
JR
JR
JR
JR
JR
JR
JR
JR
JR
JR
JR
JR
Es
Yg
Yg
Yg
Yg
Yg
Es
JR
JR
JR
JR
JR
JR
JR
JR
JR
JR
JR
"}
(4,1,1) = {"
JR
JR
JR
JR
JR
JR
JR
JR
JR
JR
JR
fT
Es
Yg
Yg
Yg
Yg
Yg
Es
fT
JR
JR
JR
JR
JR
JR
JR
JR
JR
JR
"}
(5,1,1) = {"
JR
JR
JR
JR
JR
JR
JR
JR
JR
JR
JR
Es
DS
de
LH
PH
br
de
Dx
Es
JR
JR
JR
JR
JR
JR
JR
JR
JR
JR
"}
(6,1,1) = {"
JR
JR
JR
JR
JR
JR
JR
JR
JR
JR
fT
Es
Yg
Yg
Yg
Yg
Yg
Yg
Yg
Es
fT
JR
JR
JR
JR
JR
JR
JR
JR
JR
"}
(7,1,1) = {"
JR
JR
JR
JR
JR
JR
JR
JR
JR
JR
Es
rL
Yg
qk
Dh
Dh
Dh
eF
Yg
Gi
Es
JR
JR
JR
JR
JR
JR
JR
JR
JR
"}
(8,1,1) = {"
JR
JR
JR
JR
JR
JR
JR
JR
JR
fT
Es
AV
Yg
Ti
cb
KC
cb
Cq
Yg
Yk
Es
fT
JR
JR
JR
JR
JR
JR
JR
JR
"}
(9,1,1) = {"
JR
JR
JR
JR
JR
JR
JR
JR
JR
Es
UL
lM
Yg
Ti
KC
KC
KC
Cq
Yg
lM
EL
Es
JR
JR
JR
JR
JR
JR
JR
JR
"}
(10,1,1) = {"
JR
JR
JR
JR
JR
JR
JR
JR
JR
Es
UL
lM
Yg
Ti
cb
KC
cb
Cq
Yg
lM
ws
Es
JR
JR
JR
JR
JR
JR
JR
JR
"}
(11,1,1) = {"
JR
JR
JR
JR
JR
JR
JR
JR
JR
Es
UL
lM
Yg
kj
xh
xh
xh
XX
Yg
lM
ws
Es
JR
JR
JR
JR
JR
JR
JR
JR
"}
(12,1,1) = {"
JR
JR
JR
JR
JR
JR
JR
JR
JR
fT
Es
Yg
Yg
jP
PF
DS
PF
LK
Yg
Yg
Es
fT
JR
JR
JR
JR
JR
JR
JR
JR
"}
(13,1,1) = {"
JR
JR
JR
JR
JR
JR
JR
JR
JR
JR
fT
fT
Es
YL
VI
YL
VI
Es
Es
fT
fT
JR
JR
JR
JR
JR
JR
JR
JR
JR
"}
(14,1,1) = {"
JR
JR
JR
JR
JR
JR
JR
JR
JR
JR
dn
FP
Mw
Mw
EJ
Es
uc
mS
sc
nP
dn
JR
JR
JR
JR
JR
JR
JR
JR
JR
"}
(15,1,1) = {"
JR
JR
JR
JR
JR
JR
JR
JR
JR
JR
dn
yO
Gs
Gs
rJ
Es
Vx
Gs
iu
SI
dn
JR
JR
JR
JR
JR
JR
JR
JR
JR
"}
(16,1,1) = {"
JR
JR
JR
JR
JR
JR
JR
JR
JR
JR
dn
RR
Gs
Gs
rJ
Es
hJ
Gs
pP
Lb
dn
JR
JR
JR
JR
JR
JR
JR
JR
JR
"}
(17,1,1) = {"
JR
JR
JR
JR
Ro
Ro
JR
JR
JR
JR
dn
RR
zu
Gh
dL
dJ
ld
nY
nY
Fc
dn
JR
JR
JR
JR
Ro
Ro
JR
JR
JR
"}
(18,1,1) = {"
JR
JR
JR
fT
Ck
Ck
fT
Dv
Dv
fT
fT
fN
tQ
tQ
SH
Es
jr
tQ
tQ
SH
fT
Es
Dv
Dv
fT
Ck
Ck
fT
JR
JR
"}
(19,1,1) = {"
JR
JR
JR
Es
DW
DW
Es
Dv
Dv
dn
ol
YX
YX
YX
YX
Bx
YX
YX
YX
YX
YX
dn
Dv
Dv
Es
DW
DW
Es
JR
JR
"}
(20,1,1) = {"
JR
JR
JR
Es
DW
DW
Es
Dv
Dv
dn
ol
YX
Es
Cn
Cn
Es
Cn
Cn
Es
jh
hQ
dn
Dv
Dv
Es
DW
DW
Es
JR
JR
"}
(21,1,1) = {"
JR
JR
JR
Es
DW
DW
Es
Es
Es
Es
Es
Es
Es
va
HJ
uz
va
HJ
Es
Es
Es
Es
Es
Es
Es
DW
DW
Es
JR
JR
"}
(22,1,1) = {"
JR
JR
JR
Es
DW
DW
DW
DW
Re
DW
aY
aY
Uv
PE
pV
Qe
PE
pV
be
aY
aY
DW
Re
DW
DW
DW
DW
Es
JR
JR
"}
(23,1,1) = {"
JR
JR
JR
Es
DW
DW
DW
DW
Re
DW
uP
uP
SC
PE
pV
Qe
PE
pV
zK
uP
uP
DW
Re
DW
DW
DW
DW
Es
JR
JR
"}
(24,1,1) = {"
JR
JR
JR
Es
DW
DW
Es
Es
Es
Es
Es
Es
Es
tT
FD
Et
tT
FD
Es
Es
Es
Es
Es
Es
Es
DW
DW
Es
JR
JR
"}
(25,1,1) = {"
JR
JR
JR
Es
DW
DW
Es
Dv
Dv
Es
ZD
al
Es
YX
YX
YX
YX
YX
Es
sQ
ZD
Es
Dv
Dv
Es
DW
DW
Es
JR
JR
"}
(26,1,1) = {"
JR
JR
JR
Es
Es
kl
Es
fT
Dv
Es
YX
YX
Fv
YX
Kn
tG
Kn
YX
dr
YX
YX
Es
Dv
fT
Es
kl
Es
Es
JR
JR
"}
(27,1,1) = {"
JR
JR
JR
fT
Es
DW
DW
Es
fT
Es
tK
YX
Fv
YX
Kn
Kn
Kn
YX
dr
YX
WO
Es
fT
Es
DW
DW
fT
fT
JR
JR
"}
(28,1,1) = {"
JR
JR
JR
JR
fT
Es
DW
DW
Es
Es
Om
Mf
Fv
YX
YX
YX
YX
YX
dr
RY
Om
Es
Es
DW
DW
fT
fT
JR
JR
JR
"}
(29,1,1) = {"
JR
JR
JR
JR
JR
fT
Es
DW
DW
Es
Es
Es
Es
fb
fb
fb
fb
fb
Es
Es
Es
Es
DW
DW
fT
fT
JR
JR
JR
JR
"}
(30,1,1) = {"
JR
JR
JR
JR
JR
JR
fT
DW
DW
wq
DW
DW
Es
dn
dn
jJ
dn
dn
Es
DW
DW
ms
DW
fT
fT
JR
JR
JR
JR
JR
"}
(31,1,1) = {"
JR
JR
JR
JR
JR
JR
JR
fT
Es
Es
DW
DW
Es
zv
xN
xN
xN
Hg
Es
DW
DW
Es
Es
fT
JR
JR
JR
JR
JR
JR
"}
(32,1,1) = {"
JR
JR
JR
JR
JR
JR
JR
JR
fT
Es
DW
DW
Es
zv
xN
xN
xN
Hg
Es
DW
DW
Es
fT
JR
JR
JR
JR
JR
JR
JR
"}
(33,1,1) = {"
JR
JR
JR
JR
JR
JR
JR
JR
JR
fT
fT
kl
Es
zv
xN
xN
xN
Hg
Es
kl
fT
fT
JR
JR
JR
JR
JR
JR
JR
JR
"}
(34,1,1) = {"
JR
JR
JR
JR
JR
JR
JR
JR
JR
JR
Es
DW
Re
xN
xN
xN
xN
xN
Re
DW
Es
JR
JR
JR
JR
JR
JR
JR
JR
JR
"}
(35,1,1) = {"
JR
JR
JR
JR
JR
JR
JR
JR
JR
JR
Es
DW
Re
xN
xN
xN
xN
xN
Re
DW
Es
JR
JR
JR
JR
JR
JR
JR
JR
JR
"}
(36,1,1) = {"
JR
JR
JR
JR
JR
JR
JR
JR
JR
JR
fT
Es
Es
zT
zT
XO
zT
zT
Es
fT
fT
JR
JR
JR
JR
JR
JR
JR
JR
JR
"}
(37,1,1) = {"
JR
JR
JR
JR
JR
JR
JR
JR
JR
JR
JR
FH
wl
wl
wl
wl
ZA
Sq
kx
zT
JR
JR
JR
JR
JR
JR
JR
JR
JR
JR
"}
(38,1,1) = {"
JR
JR
JR
JR
JR
JR
JR
JR
JR
JR
JR
GD
wl
wl
wl
wl
ZA
aO
XA
zT
JR
JR
JR
JR
JR
JR
JR
JR
JR
JR
"}
(39,1,1) = {"
JR
JR
JR
JR
JR
JR
JR
JR
JR
JR
JR
Zm
wl
wl
wl
wl
sr
AN
rb
zT
JR
JR
JR
JR
JR
JR
JR
JR
JR
JR
"}
(40,1,1) = {"
JR
JR
JR
JR
JR
JR
JR
JR
JR
JR
JR
Es
CR
ts
ts
wl
wl
wl
ts
Es
JR
JR
JR
JR
JR
JR
JR
JR
JR
JR
"}
(41,1,1) = {"
JR
JR
JR
JR
JR
JR
JR
JR
JR
JR
JR
fT
Es
wl
wl
wl
wl
wl
Es
fT
JR
JR
JR
JR
JR
JR
JR
JR
JR
JR
"}
(42,1,1) = {"
JR
JR
JR
JR
JR
JR
JR
JR
JR
JR
JR
JR
Es
ts
ts
wl
ts
ts
Es
JR
JR
JR
JR
JR
JR
JR
JR
JR
JR
JR
"}
(43,1,1) = {"
JR
JR
JR
JR
JR
JR
JR
JR
JR
JR
JR
JR
fT
fT
Es
XO
Es
fT
fT
JR
JR
JR
JR
JR
JR
JR
JR
JR
JR
JR
"}
(44,1,1) = {"
JR
JR
JR
JR
JR
JR
JR
JR
JR
JR
JR
JR
JR
Es
DX
xN
XF
Es
JR
JR
JR
JR
JR
JR
JR
JR
JR
JR
JR
JR
"}
(45,1,1) = {"
JR
JR
JR
JR
JR
JR
JR
JR
JR
JR
JR
JR
JR
Es
wb
xN
xN
Es
JR
JR
JR
JR
JR
JR
JR
JR
JR
JR
JR
JR
"}
(46,1,1) = {"
JR
JR
JR
JR
JR
JR
JR
JR
JR
JR
JR
JR
JR
Es
xN
Qx
xN
Es
JR
JR
JR
JR
JR
JR
JR
JR
JR
JR
JR
JR
"}
(47,1,1) = {"
JR
JR
JR
JR
JR
JR
JR
JR
JR
JR
JR
JR
JR
Es
sE
Yn
JY
Es
JR
JR
JR
JR
JR
JR
JR
JR
JR
JR
JR
JR
"}
(48,1,1) = {"
JR
JR
JR
JR
JR
JR
JR
JR
JR
JR
JR
JR
JR
fT
fT
fT
fT
fT
JR
JR
JR
JR
JR
JR
JR
JR
JR
JR
JR
JR
"}
